//MAP CONVERTED BY dmm2tgm.py THIS HEADER COMMENT PREVENTS RECONVERSION, DO NOT REMOVE
"ad" = (
/obj/effect/turf_decal/siding/white{
	dir = 10
	},
/obj/structure/railing{
	dir = 8
	},
/turf/open/floor/iron,
/area/hangar)
"ae" = (
/turf/open/misc/asteroid/snow/breathable/lit,
/area/hangar)
"ag" = (
/turf/closed/indestructible/reinforced,
/area/hangar)
"aj" = (
/obj/effect/spawner/structure/window/reinforced/indestructible,
/turf/open/floor/plating{
	planetary_atmos = 1
	},
/area/hangar)
"al" = (
/obj/effect/decal/cleanable/dirt,
/turf/open/floor/plating{
	light_color = "#1B1D2E";
	light_range = 2
	},
/area/hangar)
"an" = (
/obj/structure/chair{
	dir = 1
	},
/obj/effect/turf_decal/siding/white,
/obj/effect/turf_decal/siding/white{
	dir = 1
	},
/turf/open/floor/iron,
/area/hangar)
"ap" = (
/obj/structure/flora/grass/green,
/turf/open/misc/asteroid/snow/breathable/lit,
/area/hangar)
"as" = (
/turf/open/floor/iron/dark,
/area/hangar)
"ax" = (
/obj/machinery/light/floor,
/turf/open/floor/plating{
	light_color = "#1B1D2E";
	light_range = 2
	},
/area/hangar)
"ay" = (
/obj/effect/turf_decal/siding/white,
/obj/structure/railing{
	layer = 4.1
	},
/turf/open/floor/iron,
/area/hangar)
"aB" = (
/obj/effect/decal/fakelattice,
/obj/effect/decal/cleanable/dirt{
	color = "#808080"
	},
/obj/effect/decal/cleanable/dirt{
	color = "#808080"
	},
/turf/open/floor/plating{
	light_color = "#1B1D2E";
	light_range = 2
	},
/area/hangar)
"aE" = (
/obj/machinery/light/floor,
/turf/open/floor/iron,
/area/hangar)
"aI" = (
/obj/structure/flora/tree/dead,
/turf/open/misc/asteroid/snow/breathable/lit,
/area/hangar)
"aM" = (
/obj/structure/flora/grass/both,
/obj/structure/flora/grass/both,
/turf/open/misc/asteroid/snow/breathable/lit,
/area/hangar)
"aN" = (
/turf/open/floor/plating{
	light_color = "#1B1D2E";
	light_range = 2
	},
/area/hangar)
"aW" = (
/obj/effect/turf_decal/siding/white{
	dir = 5
	},
/obj/effect/decal/cleanable/dirt/dust,
/turf/open/floor/iron,
/area/hangar)
"aX" = (
/obj/effect/turf_decal/siding/white,
/obj/effect/decal/cleanable/dirt,
/obj/effect/decal/cleanable/dirt,
/turf/open/floor/iron,
/area/hangar)
"bq" = (
/obj/machinery/vending/coffee,
/obj/effect/decal/cleanable/wrapping,
/obj/effect/decal/cleanable/dirt/dust,
/turf/open/floor/iron,
/area/hangar)
"cY" = (
/obj/effect/turf_decal/siding/white{
	dir = 9
	},
/obj/structure/railing{
	dir = 9
	},
/turf/open/floor/iron,
/area/hangar)
"dM" = (
/obj/machinery/door/airlock{
	dir = 4
	},
/obj/machinery/door/firedoor/border_only{
	dir = 4
	},
/obj/machinery/door/firedoor/border_only{
	dir = 8
	},
/turf/open/floor/iron,
/area/hangar)
"ez" = (
/obj/machinery/door/poddoor/ert,
/turf/open/floor/plating{
	light_color = "#1B1D2E";
	light_range = 2
	},
/area/hangar)
"fC" = (
/turf/open/floor/iron,
/area/hangar)
"iY" = (
/obj/effect/turf_decal/siding/white{
	dir = 1
	},
/obj/effect/decal/cleanable/dirt,
/obj/effect/decal/cleanable/dirt,
/obj/structure/railing{
	dir = 1
	},
/turf/open/floor/iron,
/area/hangar)
"jk" = (
/obj/effect/turf_decal/siding/white{
	dir = 4
	},
/obj/effect/decal/cleanable/dirt/dust,
/turf/open/floor/iron,
/area/hangar)
"jJ" = (
/obj/effect/decal/fakelattice,
/turf/open/floor/plating{
	light_color = "#1B1D2E";
	light_range = 2
	},
/area/hangar)
"ll" = (
/obj/effect/spawner/structure/window/reinforced/indestructible,
/obj/effect/spawner/structure/window/reinforced/indestructible,
/turf/open/floor/plating{
	planetary_atmos = 1
	},
/area/hangar)
"mu" = (
/obj/effect/turf_decal/siding/white/corner,
/obj/structure/railing/corner{
	layer = 4.1
	},
/turf/open/floor/iron,
/area/hangar)
"oq" = (
/obj/effect/turf_decal/siding/white{
	dir = 1
	},
/obj/effect/decal/cleanable/dirt,
/obj/structure/railing{
	dir = 1
	},
/obj/machinery/light/small/directional/east{
	pixel_y = -8
	},
/turf/open/floor/iron,
/area/hangar)
"oy" = (
/obj/effect/turf_decal/siding/white/corner{
	dir = 8
	},
/obj/effect/decal/cleanable/dirt,
/obj/structure/railing/corner{
	dir = 8;
	layer = 4.1
	},
/turf/open/floor/iron,
/area/hangar)
"pb" = (
/obj/effect/decal/cleanable/dirt,
/obj/effect/decal/cleanable/dirt,
/obj/effect/decal/cleanable/dirt,
/turf/open/floor/iron/dark,
/area/hangar)
"pC" = (
/obj/effect/turf_decal/siding/white/corner{
	dir = 4
	},
/obj/effect/decal/cleanable/dirt,
/obj/effect/decal/cleanable/dirt,
/obj/structure/railing/corner{
	dir = 4
	},
/turf/open/floor/iron,
/area/hangar)
"pD" = (
/obj/machinery/door/airlock{
	dir = 8
	},
/turf/open/floor/iron,
/area/hangar)
"pM" = (
/obj/machinery/light/floor,
/obj/effect/decal/cleanable/dirt,
/turf/open/floor/iron,
/area/hangar)
"qq" = (
/obj/effect/decal/fakelattice,
/obj/effect/decal/cleanable/dirt{
	color = "#808080"
	},
/obj/effect/decal/cleanable/glass{
	dir = 8;
	color = "#808080"
	},
/turf/open/floor/plating{
	light_color = "#1B1D2E";
	light_range = 2
	},
/area/hangar)
"sp" = (
/obj/effect/turf_decal/siding/white{
	dir = 9
	},
/obj/effect/decal/cleanable/dirt,
/obj/structure/railing{
	dir = 8
	},
/turf/open/floor/iron,
/area/hangar)
"sE" = (
/obj/effect/turf_decal/siding/white/corner,
/obj/structure/railing/corner,
/obj/machinery/light/small/directional/east{
	pixel_y = -8
	},
/turf/open/floor/iron,
/area/hangar)
"sN" = (
/obj/effect/decal/fakelattice,
/obj/effect/decal/cleanable/oil,
/turf/open/floor/plating{
	light_color = "#1B1D2E";
	light_range = 2
	},
/area/hangar)
"uy" = (
/obj/effect/turf_decal/siding/white{
	dir = 4
	},
/obj/effect/decal/cleanable/dirt,
/obj/structure/railing{
	dir = 4
	},
/turf/open/floor/iron,
/area/hangar)
"vl" = (
/obj/effect/turf_decal/siding/white/corner{
	dir = 1
	},
/obj/effect/decal/cleanable/dirt,
/turf/open/floor/iron,
/area/hangar)
"vM" = (
/obj/effect/turf_decal/siding/white{
	dir = 1
	},
/obj/effect/decal/cleanable/dirt,
/turf/open/floor/iron,
/area/hangar)
"xt" = (
/obj/effect/turf_decal/siding/white{
	dir = 4
	},
/obj/structure/railing{
	dir = 4
	},
/turf/open/floor/iron,
/area/hangar)
"xy" = (
/obj/effect/decal/fakelattice{
	layer = 2.010
	},
/turf/open/floor/plating{
	light_color = "#1B1D2E";
	light_range = 2
	},
/area/hangar)
"zG" = (
/obj/effect/turf_decal/siding/white,
/obj/effect/decal/cleanable/dirt,
/obj/structure/railing{
	layer = 4.1
	},
/turf/open/floor/iron,
/area/hangar)
"Ag" = (
/obj/machinery/light/floor,
/obj/effect/decal/cleanable/dirt,
/obj/effect/decal/cleanable/dirt,
/obj/effect/decal/cleanable/dirt,
/turf/open/floor/iron,
/area/hangar)
"BB" = (
/obj/effect/turf_decal/siding/white{
	dir = 10
	},
/obj/structure/railing{
	layer = 4.1;
	dir = 10
	},
/turf/open/floor/iron,
/area/hangar)
"Cs" = (
/obj/effect/decal/cleanable/dirt,
/obj/effect/decal/cleanable/dirt,
/turf/open/floor/plating{
	light_color = "#1B1D2E";
	light_range = 2
	},
/area/hangar)
"Cv" = (
/obj/structure/closet/crate/bin,
/obj/machinery/light/small/directional/east{
	pixel_y = 8
	},
/obj/effect/decal/cleanable/dirt/dust,
/turf/open/floor/iron,
/area/hangar)
"Dk" = (
/obj/effect/turf_decal/siding/white{
	dir = 1
	},
/obj/effect/decal/cleanable/dirt,
/obj/structure/railing{
	dir = 1
	},
/turf/open/floor/iron,
/area/hangar)
"Dn" = (
/obj/effect/decal/cleanable/dirt,
/turf/open/floor/iron/dark,
/area/hangar)
"Eg" = (
/obj/effect/decal/fakelattice,
/obj/effect/decal/cleanable/glass{
	dir = 8;
	color = "#808080"
	},
/turf/open/floor/plating{
	light_color = "#1B1D2E";
	light_range = 2
	},
/area/hangar)
"Fs" = (
/obj/structure/flora/rock/pile/icy,
/turf/open/misc/asteroid/snow/breathable/lit,
/area/hangar)
"Fu" = (
/obj/effect/turf_decal/siding/white{
	dir = 6
	},
/obj/effect/decal/cleanable/dirt/dust,
/turf/open/floor/iron,
/area/hangar)
"GL" = (
/obj/effect/turf_decal/siding/white{
	dir = 5
	},
/obj/structure/railing{
	dir = 5
	},
/turf/open/floor/iron,
/area/hangar)
"Hr" = (
/turf/closed/indestructible/rock,
/area/hangar)
"HC" = (
/obj/effect/turf_decal/siding/white/corner{
	dir = 8
	},
/obj/effect/decal/cleanable/dirt,
/turf/open/floor/iron,
/area/hangar)
"Jh" = (
/obj/effect/decal/fakelattice,
/obj/effect/decal/cleanable/dirt{
	color = "#808080"
	},
/obj/machinery/light/small/directional/east,
/turf/open/floor/plating{
	light_color = "#1B1D2E";
	light_range = 2
	},
/area/hangar)
"KH" = (
/obj/structure/flora/grass/both,
/turf/open/misc/asteroid/snow/breathable/lit,
/area/hangar)
"Mx" = (
/obj/effect/decal/cleanable/dirt,
/obj/effect/decal/cleanable/dirt,
/obj/effect/decal/cleanable/dirt,
/turf/open/floor/plating{
	light_color = "#1B1D2E";
	light_range = 2
	},
/area/hangar)
"MB" = (
/obj/effect/decal/fakelattice,
/obj/effect/decal/cleanable/greenglow{
	color = "#808080"
	},
/obj/effect/decal/cleanable/dirt{
	color = "#808080"
	},
/obj/effect/decal/cleanable/dirt{
	color = "#808080"
	},
/turf/open/floor/plating{
	light_color = "#1B1D2E";
	light_range = 2
	},
/area/hangar)
"NE" = (
/obj/structure/flora/tree/pine,
/turf/open/misc/asteroid/snow/breathable/lit,
/area/hangar)
"OC" = (
/obj/effect/turf_decal/siding/white,
/obj/effect/decal/cleanable/dirt,
/obj/effect/decal/cleanable/dirt,
/obj/structure/railing{
	layer = 4.1
	},
/turf/open/floor/iron,
/area/hangar)
"OZ" = (
/obj/effect/turf_decal/siding/white,
/turf/open/floor/iron,
/area/hangar)
"Pu" = (
/obj/effect/turf_decal/siding/white{
	dir = 4
	},
/turf/open/floor/iron,
/area/hangar)
"PW" = (
/obj/effect/turf_decal/siding/white{
	dir = 6
	},
/obj/structure/railing{
	layer = 4.1;
	dir = 6
	},
/turf/open/floor/iron,
/area/hangar)
"Rs" = (
/obj/effect/turf_decal/siding/white,
/obj/effect/decal/cleanable/dirt,
/turf/open/floor/iron,
/area/hangar)
"RC" = (
/obj/effect/turf_decal/siding/white{
	dir = 8
	},
/turf/open/floor/iron,
/area/hangar)
"RI" = (
/obj/effect/turf_decal/siding/white{
	dir = 4
	},
/obj/effect/decal/cleanable/dirt,
/obj/effect/decal/cleanable/dirt,
/turf/open/floor/iron,
/area/hangar)
"Sk" = (
/obj/effect/turf_decal/siding/white{
	dir = 9
	},
/obj/effect/decal/cleanable/dirt/dust,
/turf/open/floor/iron,
/area/hangar)
"SC" = (
/obj/effect/turf_decal/siding/white{
	dir = 1
	},
/turf/open/floor/iron,
/area/hangar)
"SS" = (
/obj/effect/decal/fakelattice,
/obj/effect/decal/cleanable/dirt{
	color = "#808080"
	},
/turf/open/floor/plating{
	light_color = "#1B1D2E";
	light_range = 2
	},
/area/hangar)
"Tj" = (
/obj/effect/decal/cleanable/dirt,
/obj/effect/decal/cleanable/dirt,
/turf/open/floor/iron/dark,
/area/hangar)
"Uo" = (
/obj/structure/chair{
	dir = 1
	},
/obj/effect/turf_decal/siding/white,
/obj/effect/turf_decal/siding/white{
	dir = 1
	},
/obj/machinery/light/small/directional/east{
	pixel_y = -8
	},
/obj/effect/decal/cleanable/dirt/dust,
/turf/open/floor/iron,
/area/hangar)
"UJ" = (
/obj/effect/turf_decal/siding/white{
	dir = 1
	},
/obj/structure/railing{
	dir = 1
	},
/turf/open/floor/iron,
/area/hangar)
"VH" = (
/obj/effect/turf_decal/siding/white{
	dir = 10
	},
/obj/structure/rack,
/obj/item/clothing/suit/hooded/wintercoat,
/obj/item/clothing/suit/hooded/wintercoat,
/obj/item/clothing/suit/hooded/wintercoat{
	pixel_y = 3
	},
/obj/item/clothing/suit/hooded/wintercoat{
	pixel_y = 3
	},
/obj/item/clothing/suit/hooded/wintercoat{
	pixel_y = 6
	},
/obj/item/clothing/suit/hooded/wintercoat{
	pixel_y = 6
	},
/obj/structure/railing{
	layer = 4.1;
	dir = 10
	},
/turf/open/floor/iron,
/area/hangar)
"WP" = (
/obj/effect/turf_decal/siding/white{
	dir = 10
	},
/obj/effect/decal/cleanable/dirt/dust,
/turf/open/floor/iron,
/area/hangar)
"XO" = (
/obj/effect/turf_decal/siding/white{
	dir = 6
	},
/obj/structure/rack,
/obj/item/clothing/suit/hooded/wintercoat,
/obj/item/clothing/suit/hooded/wintercoat,
/obj/item/clothing/suit/hooded/wintercoat{
	pixel_y = 3
	},
/obj/item/clothing/suit/hooded/wintercoat{
	pixel_y = 3
	},
/obj/item/clothing/suit/hooded/wintercoat{
	pixel_y = 6
	},
/obj/item/clothing/suit/hooded/wintercoat{
	pixel_y = 6
	},
/obj/structure/railing{
	layer = 4.1;
	dir = 6
	},
/turf/open/floor/iron,
/area/hangar)
"XU" = (
/obj/effect/decal/fakelattice,
/obj/machinery/light/small/directional/east,
/obj/effect/decal/cleanable/dirt{
	color = "#808080"
	},
/turf/open/floor/plating{
	light_color = "#1B1D2E";
	light_range = 2
	},
/area/hangar)
"YB" = (
/obj/effect/turf_decal/siding/white{
	dir = 8
	},
/obj/effect/decal/cleanable/dirt/dust,
/obj/effect/decal/cleanable/dirt/dust,
/turf/open/floor/iron,
/area/hangar)
"YS" = (
/obj/effect/turf_decal/siding/white{
	dir = 1
	},
/turf/open/floor/iron/dark,
/area/hangar)
"YT" = (
/obj/effect/decal/cleanable/dirt,
/obj/effect/decal/cleanable/dirt,
/obj/effect/decal/cleanable/dirt,
/obj/effect/decal/cleanable/dirt,
/turf/open/floor/iron/dark,
/area/hangar)
"ZK" = (
/obj/effect/turf_decal/siding/white{
	dir = 8
	},
/obj/structure/railing{
	dir = 8
	},
/turf/open/floor/iron,
/area/hangar)
"ZZ" = (
/obj/effect/turf_decal/siding/white{
	dir = 1
	},
/obj/effect/decal/cleanable/dirt,
/obj/effect/decal/cleanable/dirt,
/turf/open/floor/iron,
/area/hangar)

(1,1,1) = {"
Hr
Hr
Hr
Hr
Hr
Hr
Hr
Hr
Hr
Hr
Hr
Hr
Hr
Hr
Hr
Hr
Hr
Hr
Hr
Hr
Hr
Hr
Hr
Hr
Hr
Hr
Hr
Hr
Hr
Hr
Hr
Hr
Hr
Hr
Hr
Hr
Hr
Hr
Hr
Hr
"}
(2,1,1) = {"
Hr
Hr
Hr
Hr
Hr
Hr
Hr
Hr
Hr
Hr
Hr
Hr
Hr
Hr
Hr
Hr
Hr
Hr
Hr
Hr
Hr
Hr
Hr
Hr
Hr
Hr
Hr
Hr
Hr
Hr
Hr
Hr
Hr
Hr
Hr
Hr
Hr
Hr
Hr
Hr
"}
(3,1,1) = {"
Hr
Hr
Hr
Hr
Hr
Hr
Hr
Hr
Hr
ae
ae
ae
ae
Hr
Hr
Hr
Hr
Hr
Hr
Hr
Hr
Hr
Hr
Hr
Hr
ae
ae
ae
ae
ae
ae
ae
ae
ae
ae
Hr
Hr
Hr
Hr
Hr
"}
(4,1,1) = {"
Hr
Hr
Hr
Hr
Hr
Hr
Hr
Hr
Hr
ae
ae
ae
ae
ae
ae
ae
ae
ae
ae
ae
ae
ae
ae
ae
ae
ae
Fs
ae
ae
ae
ae
ae
ae
ae
ae
Hr
Hr
Hr
Hr
Hr
"}
(5,1,1) = {"
Hr
Hr
Hr
Hr
ae
ae
ae
ae
ae
aI
ae
KH
ae
ae
ae
ae
ae
ae
ae
ae
KH
ae
ae
ae
ae
ae
ae
ae
ae
ae
ae
ae
ae
ae
ae
Hr
Hr
Hr
Hr
Hr
"}
(6,1,1) = {"
Hr
Hr
Hr
Hr
ae
ae
ae
ae
ae
KH
ae
ae
ae
KH
ae
ae
ae
KH
ae
ae
ae
ae
ae
ae
ae
ae
ap
ae
ae
ae
ae
NE
ae
ae
ae
Hr
Hr
Hr
Hr
Hr
"}
(7,1,1) = {"
Hr
Hr
Hr
Hr
ae
ae
ae
NE
ae
ae
ae
ae
ae
ae
ae
ae
ae
ae
ap
ae
ae
ae
KH
ae
ae
Fs
ae
KH
ae
ae
ae
ae
ae
NE
ae
Hr
Hr
Hr
Hr
Hr
"}
(8,1,1) = {"
Hr
Hr
Hr
Hr
ae
ae
ae
ae
ae
ae
ae
ae
ae
ae
ae
ae
ae
ae
ae
ae
ae
ae
ae
ae
ae
ae
ae
ae
ae
ae
ae
ae
ae
ae
Fs
ae
ae
Hr
Hr
Hr
"}
(9,1,1) = {"
Hr
Hr
Hr
Hr
KH
ae
ae
ae
ae
ae
ae
KH
ae
ae
ap
ae
ae
ae
ae
ae
ae
ae
ae
ae
ae
KH
ae
ae
ae
ae
ae
NE
ae
ae
ae
ae
ae
Hr
Hr
Hr
"}
(10,1,1) = {"
Hr
Hr
Hr
ae
ae
ae
ae
ae
NE
ae
ae
ae
ae
Fs
ae
ae
ae
ae
ae
ae
ae
KH
ae
ap
ae
ae
ae
ae
aI
ae
ae
ae
ae
ae
ae
NE
ae
Hr
Hr
Hr
"}
(11,1,1) = {"
Hr
Hr
ae
ae
ae
NE
ae
ae
ae
ae
ae
ae
ap
ae
ae
ae
KH
ae
ae
ae
ae
ae
ae
ae
ae
KH
ae
ae
ae
KH
ae
ae
ae
ae
KH
ae
ae
Hr
Hr
Hr
"}
(12,1,1) = {"
Hr
Hr
ae
ae
ae
ae
ae
KH
ae
ae
ae
ae
ae
ae
ae
ae
ae
ae
ae
ae
ae
ae
ae
ae
ae
ae
ae
ae
ae
ae
ae
ae
ae
ae
ae
KH
ae
Hr
Hr
Hr
"}
(13,1,1) = {"
Hr
Hr
ae
ae
KH
ae
ae
cY
ZK
ad
Dn
Dn
as
as
as
Dn
Dn
Dn
Dn
Dn
Dn
Dn
Tj
Dn
Dn
Dn
Dn
as
as
Dn
sp
ZK
BB
ae
ae
ae
ae
Hr
Hr
Hr
"}
(14,1,1) = {"
Hr
Hr
ae
ae
ae
ae
KH
iY
aE
as
as
as
as
Dn
Dn
Dn
Dn
Dn
Tj
Dn
as
as
as
as
as
Dn
Dn
Dn
Dn
Dn
YS
Ag
ay
ae
ae
NE
ae
Hr
Hr
Hr
"}
(15,1,1) = {"
Hr
Hr
ae
ae
ae
NE
ae
Dk
Tj
Rs
aN
aN
ax
aN
aN
aN
aN
ax
aN
aN
aN
aN
ax
aN
aN
aN
aN
ax
aN
aN
SC
Tj
ay
ae
ap
ae
KH
Hr
Hr
Hr
"}
(16,1,1) = {"
Hr
Hr
ae
ap
ae
ap
ae
UJ
Tj
Rs
aN
aN
aN
aN
aN
aN
aN
aN
aN
aN
aN
aN
aN
aN
aN
aN
aN
aN
aN
aN
SC
Dn
zG
ap
ae
ae
ae
Hr
Hr
Hr
"}
(17,1,1) = {"
Hr
Hr
ae
ae
ae
ae
NE
UJ
Tj
aX
ax
aN
aN
aN
aN
aN
aN
aN
aN
aN
aN
aN
aN
aN
aN
aN
aN
aN
aN
ax
SC
Tj
zG
ae
NE
ae
ae
Hr
Hr
Hr
"}
(18,1,1) = {"
Hr
Hr
ae
ae
NE
ae
KH
UJ
Tj
OZ
aN
aN
aN
aN
aN
aN
aN
aN
aN
aN
aN
aN
aN
aN
aN
aN
aN
aN
aN
aN
vM
pb
zG
KH
ae
ae
ae
Hr
Hr
Hr
"}
(19,1,1) = {"
Hr
Hr
ae
ae
KH
ae
ae
UJ
Dn
OZ
aN
aN
aN
aN
aN
aN
aN
aN
aN
aN
aN
aN
aN
aN
aN
aN
aN
aN
aN
aN
vM
Tj
ay
ae
ae
ae
NE
Hr
Hr
Hr
"}
(20,1,1) = {"
Hr
Hr
ae
ae
ae
ae
ae
UJ
Dn
OZ
aN
aN
aN
aN
aN
aN
aN
aN
aN
aN
aN
aN
aN
aN
aN
aN
aN
aN
aN
aN
SC
as
zG
KH
ae
ap
ae
Hr
Hr
Hr
"}
(21,1,1) = {"
Hr
Hr
ae
ae
ae
ae
ae
UJ
Dn
OZ
aN
aN
aN
aN
aN
aN
aN
aN
aN
aN
aN
aN
aN
aN
aN
aN
aN
aN
aN
aN
SC
as
zG
ae
ae
ae
ae
Hr
Hr
Hr
"}
(22,1,1) = {"
Hr
Hr
ae
ae
ae
NE
KH
UJ
Dn
OZ
ax
aN
aN
aN
aN
aN
aN
aN
aN
aN
aN
aN
aN
aN
aN
aN
aN
aN
aN
ax
SC
aN
zG
ae
ae
ae
ae
Hr
Hr
Hr
"}
(23,1,1) = {"
Hr
Hr
ae
ae
KH
ae
ae
UJ
Dn
OZ
aN
aN
aN
aN
aN
aN
aN
aN
aN
aN
aN
aN
aN
aN
aN
aN
aN
aN
aN
aN
SC
aN
zG
ae
NE
KH
ae
Hr
Hr
Hr
"}
(24,1,1) = {"
Hr
Hr
ae
ap
ae
KH
ae
Dk
Dn
OZ
aN
aN
aN
aN
aN
aN
aN
aN
aN
aN
aN
aN
aN
aN
aN
aN
aN
aN
aN
aN
SC
aN
zG
KH
ae
ae
ae
Hr
Hr
Hr
"}
(25,1,1) = {"
Hr
Hr
ae
ae
NE
ae
ae
Dk
Dn
OZ
aN
aN
aN
aN
aN
aN
aN
aN
aN
aN
aN
aN
aN
aN
aN
aN
aN
aN
aN
aN
SC
aN
zG
ae
ae
NE
ae
Hr
Hr
Hr
"}
(26,1,1) = {"
Hr
Hr
ae
Fs
ae
ae
NE
Dk
as
OZ
aN
aN
aN
aN
aN
aN
aN
aN
aN
aN
aN
aN
aN
aN
aN
aN
aN
aN
aN
aN
vM
aN
zG
ap
ae
ae
ae
Hr
Hr
Hr
"}
(27,1,1) = {"
Hr
Hr
ae
ae
ap
KH
ae
Dk
as
OZ
ax
aN
aN
aN
aN
aN
aN
aN
aN
aN
aN
aN
aN
aN
aN
aN
aN
aN
aN
ax
SC
Cs
zG
ae
KH
Fs
ae
Hr
Hr
Hr
"}
(28,1,1) = {"
Hr
Hr
Hr
ae
ae
ae
KH
Dk
as
OZ
aN
aN
aN
aN
aN
aN
aN
aN
aN
aN
aN
aN
aN
aN
aN
aN
aN
aN
aN
aN
SC
al
ay
ae
ae
ae
ae
Hr
Hr
Hr
"}
(29,1,1) = {"
Hr
Hr
Hr
ae
ae
ap
ae
UJ
as
OZ
aN
aN
aN
aN
aN
aN
aN
aN
aN
aN
aN
aN
aN
aN
aN
aN
aN
aN
aN
aN
SC
al
ay
KH
ae
ae
ae
Hr
Hr
Hr
"}
(30,1,1) = {"
Hr
Hr
Hr
ae
KH
ae
NE
UJ
as
OZ
aN
aN
aN
aN
aN
aN
aN
aN
aN
aN
aN
aN
aN
aN
aN
aN
aN
aN
aN
aN
SC
al
zG
ae
ae
KH
ae
Hr
Hr
Hr
"}
(31,1,1) = {"
Hr
Hr
Hr
KH
ae
ae
KH
UJ
as
Rs
aN
aN
aN
aN
aN
aN
aN
aN
aN
aN
aN
aN
aN
aN
aN
aN
aN
aN
aN
aN
SC
al
ay
ae
ae
NE
ae
Hr
Hr
Hr
"}
(32,1,1) = {"
Hr
Hr
Hr
ae
ae
NE
ae
UJ
Tj
Rs
ax
aN
aN
aN
aN
aN
aN
aN
aN
aN
aN
aN
aN
aN
aN
aN
aN
aN
aN
ax
SC
al
zG
ae
ae
ae
ae
Hr
Hr
Hr
"}
(33,1,1) = {"
Hr
Hr
Hr
ae
ae
ap
ae
UJ
Tj
aX
aN
aN
aN
aN
aN
aN
aN
aN
aN
aN
aN
aN
aN
aN
aN
aN
aN
aN
aN
aN
SC
Cs
zG
ap
ae
KH
ae
Hr
Hr
Hr
"}
(34,1,1) = {"
Hr
Hr
Hr
ae
KH
ae
ap
UJ
Tj
OZ
aN
aN
aN
aN
aN
aN
aN
aN
aN
aN
aN
aN
aN
aN
aN
aN
aN
aN
aN
aN
vM
Mx
zG
ae
NE
ae
Hr
Hr
Hr
Hr
"}
(35,1,1) = {"
Hr
Hr
Hr
ae
ae
ae
ae
UJ
Dn
OZ
aN
aN
aN
aN
aN
aN
aN
aN
aN
aN
aN
aN
aN
aN
aN
aN
aN
aN
aN
aN
vM
Tj
ay
ae
ae
ap
Hr
Hr
Hr
Hr
"}
(36,1,1) = {"
Hr
Hr
Hr
ae
ae
ae
ap
UJ
Dn
OZ
aN
aN
aN
aN
aN
aN
aN
aN
aN
aN
aN
aN
aN
aN
aN
aN
aN
aN
aN
aN
SC
as
zG
ae
ae
ae
Hr
Hr
Hr
Hr
"}
(37,1,1) = {"
Hr
Hr
Hr
ae
ae
NE
ae
UJ
Dn
OZ
ax
aN
aN
aN
aN
aN
aN
aN
aN
aN
aN
aN
aN
aN
aN
aN
aN
aN
aN
ax
SC
as
zG
ae
KH
ae
Hr
Hr
Hr
Hr
"}
(38,1,1) = {"
Hr
Hr
Hr
ae
ae
ae
KH
UJ
Dn
OZ
aN
aN
aN
aN
aN
aN
aN
aN
aN
aN
aN
aN
aN
aN
aN
aN
aN
aN
aN
aN
SC
as
zG
ae
ae
ae
Hr
Hr
Hr
Hr
"}
(39,1,1) = {"
Hr
Hr
Hr
ae
ae
ap
ae
UJ
Dn
OZ
aN
aN
aN
aN
aN
aN
aN
aN
aN
aN
aN
aN
aN
aN
aN
aN
aN
aN
aN
aN
SC
as
zG
ae
ae
ae
Hr
Hr
Hr
Hr
"}
(40,1,1) = {"
Hr
Hr
Hr
ae
ae
Fs
ae
Dk
Dn
OZ
aN
aN
aN
aN
aN
aN
aN
aN
aN
aN
aN
aN
aN
aN
aN
aN
aN
aN
aN
aN
SC
as
zG
ae
NE
ae
Hr
Hr
Hr
Hr
"}
(41,1,1) = {"
Hr
Hr
ae
ae
ae
ae
ae
Dk
Dn
OZ
aN
aN
aN
aN
aN
aN
aN
aN
aN
aN
aN
aN
aN
aN
aN
aN
aN
aN
aN
aN
SC
as
zG
ae
ap
ae
Hr
Hr
Hr
Hr
"}
(42,1,1) = {"
Hr
Hr
ae
ae
ae
ae
ae
Dk
as
OZ
ax
aN
aN
aN
aN
aN
aN
aN
aN
aN
aN
aN
aN
aN
aN
aN
aN
aN
aN
ax
vM
as
zG
KH
ae
ae
Hr
Hr
Hr
Hr
"}
(43,1,1) = {"
Hr
Hr
ae
ae
ae
KH
ae
Dk
as
OZ
aN
aN
aN
aN
aN
aN
aN
aN
aN
aN
aN
aN
aN
aN
aN
aN
aN
aN
aN
aN
SC
Tj
zG
ae
ae
ae
Hr
Hr
Hr
Hr
"}
(44,1,1) = {"
Hr
Hr
Hr
ae
ae
ae
ap
Dk
as
OZ
aN
aN
aN
aN
aN
aN
aN
aN
aN
aN
aN
aN
aN
aN
aN
aN
aN
aN
aN
aN
SC
Dn
ay
ae
NE
ae
Hr
Hr
Hr
Hr
"}
(45,1,1) = {"
Hr
Hr
Hr
ae
ae
ae
NE
UJ
as
OZ
aN
aN
aN
aN
aN
aN
aN
aN
aN
aN
aN
aN
aN
aN
aN
aN
aN
aN
aN
aN
SC
Dn
ay
ae
ae
ae
Hr
Hr
Hr
Hr
"}
(46,1,1) = {"
Hr
Hr
Hr
ae
ae
ae
ae
UJ
as
OZ
aN
aN
aN
aN
aN
aN
aN
aN
aN
aN
aN
aN
aN
aN
aN
aN
aN
aN
aN
aN
SC
Dn
zG
ae
KH
ae
Hr
Hr
Hr
Hr
"}
(47,1,1) = {"
Hr
Hr
Hr
ae
ae
KH
ae
UJ
as
Rs
ax
aN
aN
aN
aN
aN
aN
aN
aN
aN
aN
aN
aN
aN
aN
aN
aN
aN
aN
ax
SC
Dn
ay
ae
ae
ae
ae
Hr
Hr
Hr
"}
(48,1,1) = {"
Hr
Hr
Hr
ae
ae
ae
ae
UJ
Dn
Rs
aN
aN
aN
aN
aN
aN
aN
aN
aN
aN
aN
aN
aN
aN
aN
aN
aN
aN
aN
aN
SC
Dn
ay
ae
ae
ap
Fs
Hr
Hr
Hr
"}
(49,1,1) = {"
Hr
Hr
Hr
ae
ae
ap
ae
UJ
Dn
OZ
aN
aN
aN
aN
aN
aN
aN
aN
aN
aN
aN
aN
aN
aN
aN
aN
aN
aN
aN
aN
ZZ
Tj
ay
ae
ae
NE
ae
Hr
Hr
Hr
"}
(50,1,1) = {"
Hr
Hr
Hr
ae
ae
ae
KH
SC
Dn
OZ
aN
aN
aN
aN
aN
aN
aN
aN
aN
aN
aN
aN
aN
aN
aN
aN
aN
aN
aN
aN
SC
Dn
OZ
ae
ae
ae
ae
Hr
Hr
Hr
"}
(51,1,1) = {"
Hr
Hr
Hr
ae
ae
NE
ae
UJ
Dn
OZ
aN
aN
aN
aN
aN
aN
aN
aN
aN
aN
aN
aN
aN
aN
aN
aN
aN
aN
aN
aN
SC
Dn
ay
KH
ae
ae
ae
Hr
Hr
Hr
"}
(52,1,1) = {"
Hr
Hr
Hr
ae
ae
ae
ae
UJ
Dn
OZ
ax
aN
aN
aN
aN
aN
aN
aN
aN
aN
aN
aN
aN
aN
aN
aN
aN
aN
aN
ax
SC
as
ay
NE
ae
KH
ae
Hr
Hr
Hr
"}
(53,1,1) = {"
Hr
Hr
Hr
ae
ae
ae
NE
Dk
as
OZ
aN
aN
aN
aN
aN
aN
aN
aN
aN
aN
aN
aN
aN
aN
aN
aN
aN
aN
aN
aN
SC
Dn
ay
ae
ae
ae
ae
Hr
Hr
Hr
"}
(54,1,1) = {"
Hr
Hr
Hr
ae
KH
ae
ae
UJ
as
OZ
aN
aN
aN
aN
aN
aN
aN
aN
aN
aN
aN
aN
aN
aN
aN
aN
aN
aN
aN
aN
SC
Dn
zG
ae
ae
ae
ae
Hr
Hr
Hr
"}
(55,1,1) = {"
Hr
Hr
Hr
ae
ae
ap
ae
Dk
Dn
OZ
aN
aN
aN
aN
aN
aN
aN
aN
aN
aN
aN
aN
aN
aN
aN
aN
aN
aN
aN
aN
vM
Dn
ay
KH
ae
ae
ae
Hr
Hr
Hr
"}
(56,1,1) = {"
Hr
Hr
Hr
ae
ae
NE
ap
UJ
Tj
OZ
aN
aN
aN
aN
aN
aN
aN
aN
aN
aN
aN
aN
aN
aN
aN
aN
aN
aN
aN
aN
SC
Dn
ay
ae
NE
ae
ae
Hr
Hr
Hr
"}
(57,1,1) = {"
Hr
Hr
Hr
ae
ae
ae
ae
UJ
pb
OZ
ax
aN
aN
aN
aN
aN
aN
aN
aN
aN
aN
aN
aN
aN
aN
aN
aN
aN
aN
ax
SC
Tj
ay
ae
ae
ae
ae
Hr
Hr
Hr
"}
(58,1,1) = {"
Hr
Hr
Hr
Fs
ae
KH
ae
UJ
YT
OZ
aN
aN
aN
aN
aN
aN
aN
aN
aN
aN
aN
aN
aN
aN
aN
aN
aN
aN
aN
aN
SC
Tj
ay
ae
KH
ae
ae
Hr
Hr
Hr
"}
(59,1,1) = {"
Hr
Hr
Hr
ae
ae
ae
KH
UJ
Tj
Rs
aN
aN
aN
aN
aN
aN
aN
aN
aN
aN
aN
aN
aN
aN
aN
aN
aN
aN
aN
aN
SC
Tj
ay
ae
ae
ae
ae
Hr
Hr
Hr
"}
(60,1,1) = {"
Hr
Hr
ae
ae
NE
ae
ae
UJ
Tj
Rs
aN
aN
aN
aN
aN
aN
aN
aN
aN
aN
aN
aN
aN
aN
aN
aN
aN
aN
aN
aN
SC
Tj
zG
ap
ae
ae
ae
Hr
Hr
Hr
"}
(61,1,1) = {"
Hr
Hr
ae
ae
ae
ae
NE
Dk
Dn
Rs
aN
aN
aN
aN
aN
aN
aN
aN
aN
aN
aN
aN
aN
aN
aN
aN
aN
aN
aN
aN
SC
Dn
OC
ae
ae
ae
ae
Hr
Hr
Hr
"}
(62,1,1) = {"
Hr
Hr
ae
ae
KH
ae
ae
UJ
Dn
OZ
ax
aN
aN
aN
aN
aN
aN
aN
aN
aN
aN
aN
aN
aN
aN
aN
aN
aN
aN
ax
SC
Tj
OC
KH
ae
ae
ae
Hr
Hr
Hr
"}
(63,1,1) = {"
Hr
Hr
ae
ae
ae
ae
ae
UJ
Dn
OZ
aN
aN
aN
aN
aN
aN
aN
aN
aN
aN
aN
aN
aN
aN
aN
aN
aN
aN
aN
aN
vM
as
ay
NE
ae
ae
ae
Hr
Hr
Hr
"}
(64,1,1) = {"
Hr
Hr
ae
ae
ae
KH
ae
UJ
as
OZ
aN
aN
aN
aN
aN
aN
aN
aN
aN
aN
aN
aN
aN
aN
aN
aN
aN
aN
aN
aN
vM
Dn
ay
ae
ae
ae
ae
Hr
Hr
Hr
"}
(65,1,1) = {"
Hr
Hr
ae
ae
ae
NE
ae
UJ
as
OZ
aN
aN
aN
aN
aN
aN
aN
aN
aN
aN
aN
aN
aN
aN
aN
aN
aN
aN
aN
aN
vM
Dn
ay
ae
KH
ae
ae
Hr
Hr
Hr
"}
(66,1,1) = {"
Hr
Hr
ae
ae
ae
ap
ae
UJ
as
OZ
aN
aN
aN
aN
aN
aN
aN
aN
aN
aN
aN
aN
aN
aN
aN
aN
aN
aN
aN
aN
SC
Dn
ay
ae
NE
ae
ae
Hr
Hr
Hr
"}
(67,1,1) = {"
Hr
Hr
ae
ae
ae
ae
NE
UJ
as
OZ
aN
aN
aN
aN
aN
aN
aN
aN
aN
aN
aN
aN
aN
aN
aN
aN
aN
aN
aN
aN
SC
Tj
ay
ae
ae
ae
ae
Hr
Hr
Hr
"}
(68,1,1) = {"
Hr
Hr
ae
KH
ae
ae
ae
UJ
Dn
Rs
ax
aN
aN
aN
aN
aN
aN
aN
aN
aN
aN
aN
aN
aN
aN
aN
aN
aN
aN
ax
SC
Tj
ay
KH
Fs
ae
ae
Hr
Hr
Hr
"}
(69,1,1) = {"
Hr
Hr
ae
ae
ae
KH
ae
Dk
Dn
Rs
aN
aN
aN
aN
aN
aN
aN
aN
aN
aN
aN
aN
aN
aN
aN
aN
aN
aN
aN
aN
SC
Dn
ay
ae
ae
ae
Hr
Hr
Hr
Hr
"}
(70,1,1) = {"
Hr
Hr
ae
ae
ae
ae
ae
Dk
as
Rs
aN
aN
ax
aN
aN
aN
aN
ax
aN
aN
aN
aN
ax
aN
aN
aN
aN
ax
aN
aN
SC
as
ay
ap
ae
ae
Hr
Hr
Hr
Hr
"}
(71,1,1) = {"
Hr
Hr
ae
ae
NE
ae
ae
UJ
as
HC
RC
RC
RC
RC
RC
RC
RC
RC
RC
RC
RC
RC
RC
RC
RC
RC
RC
RC
RC
RC
vl
as
ay
KH
ae
ae
Hr
Hr
Hr
Hr
"}
(72,1,1) = {"
Hr
Hr
ae
ae
KH
ae
ae
UJ
aE
as
Tj
Dn
Dn
Dn
as
Tj
Tj
Dn
Dn
as
pM
as
Dn
as
as
as
Tj
Tj
Dn
as
as
pM
zG
ae
ae
ae
Hr
Hr
Hr
Hr
"}
(73,1,1) = {"
Hr
Hr
ae
ae
ae
ae
NE
GL
xt
xt
xt
Pu
uy
xt
xt
xt
xt
uy
uy
pC
Tj
mu
Pu
xt
xt
xt
xt
xt
RI
uy
uy
uy
PW
ae
KH
ae
Hr
Hr
Hr
Hr
"}
(74,1,1) = {"
Hr
Hr
Hr
ae
ae
ae
ae
ae
ae
ae
ae
ae
ae
ae
ae
ap
ae
ae
KH
UJ
Dn
zG
ae
ae
ae
KH
ae
ae
ae
ap
ae
ae
ae
NE
ae
ae
Hr
Hr
Hr
Hr
"}
(75,1,1) = {"
Hr
Hr
Hr
ae
ae
KH
ae
ap
ae
KH
ae
ae
NE
KH
ae
ae
ae
NE
ae
UJ
Dn
oy
VH
KH
ae
ae
ae
KH
ae
NE
ae
ae
KH
ae
ae
ae
Hr
Hr
Hr
Hr
"}
(76,1,1) = {"
Hr
Hr
Hr
ae
NE
ae
ae
aI
ae
ae
ae
ap
ae
ae
ae
KH
ae
ae
ae
UJ
Tj
fC
ay
ae
ae
NE
ae
KH
ae
ae
ae
ae
ae
ae
ae
ae
Hr
Hr
Hr
Hr
"}
(77,1,1) = {"
Hr
Hr
Hr
ae
ae
ae
ae
ae
ae
ae
ae
ae
ae
ae
aI
ae
ae
ap
ae
oq
Dn
sE
XO
ae
ae
KH
ae
ae
ae
KH
ae
KH
ae
ae
NE
ae
Hr
Hr
Hr
Hr
"}
(78,1,1) = {"
Hr
Hr
Hr
ae
ae
ae
NE
KH
ae
ae
ae
NE
ae
ae
ae
ae
ae
ag
ag
ag
dM
ag
ag
ag
Fs
ae
KH
ae
ae
ae
NE
ae
ae
ae
ae
ae
Hr
Hr
Hr
Hr
"}
(79,1,1) = {"
Hr
Hr
Hr
ae
ae
ae
ae
Fs
ae
ae
ae
ae
KH
ae
ae
ae
ae
ag
bq
Sk
YB
WP
an
ag
ae
ae
ae
ae
ae
ae
ae
aM
ae
ae
ae
ae
Hr
Hr
Hr
Hr
"}
(80,1,1) = {"
Hr
Hr
Hr
ae
ae
ae
ae
ae
ap
ae
KH
ae
ae
ae
ae
ae
ae
ag
Cv
aW
jk
Fu
Uo
ag
ae
ae
ae
KH
ae
KH
ae
ae
ae
ae
ae
ae
Hr
Hr
Hr
Hr
"}
(81,1,1) = {"
ag
ag
ag
ag
ag
ag
ag
ag
aj
aj
aj
aj
ag
ag
ag
ag
ag
ag
ag
pD
pD
pD
ag
ag
ag
ag
ag
aj
ll
aj
aj
ag
ag
ag
ag
ag
ag
ag
ag
ag
"}
(82,1,1) = {"
ag
jJ
jJ
jJ
ez
jJ
aB
aB
SS
SS
MB
SS
aB
SS
SS
jJ
SS
SS
ez
xy
xy
xy
ez
jJ
aB
aB
SS
jJ
SS
SS
MB
SS
aB
SS
SS
ez
jJ
SS
aB
ag
"}
(83,1,1) = {"
ag
jJ
jJ
jJ
ez
jJ
aB
aB
aB
SS
jJ
sN
aB
SS
SS
jJ
qq
SS
ez
xy
xy
xy
ez
jJ
aB
aB
SS
jJ
qq
SS
jJ
sN
aB
SS
qq
ez
jJ
jJ
aB
ag
"}
(84,1,1) = {"
ag
jJ
jJ
jJ
ez
jJ
jJ
jJ
XU
jJ
jJ
SS
aB
aB
Jh
jJ
jJ
jJ
ez
xy
xy
xy
ez
Eg
SS
aB
jJ
jJ
SS
aB
aB
Jh
aB
aB
jJ
ez
jJ
SS
aB
ag
"}
(85,1,1) = {"
ag
ag
ag
ag
ag
Hr
Hr
Hr
ag
Hr
Hr
Hr
Hr
Hr
ag
Hr
Hr
Hr
ag
ag
ag
ag
ag
Hr
Hr
Hr
Hr
Hr
Hr
Hr
Hr
ag
Hr
Hr
Hr
ag
ag
ag
ag
ag
"}
(86,1,1) = {"
Hr
Hr
Hr
Hr
Hr
Hr
Hr
Hr
Hr
Hr
Hr
Hr
Hr
Hr
Hr
Hr
Hr
Hr
Hr
Hr
Hr
Hr
Hr
Hr
Hr
Hr
Hr
Hr
Hr
Hr
Hr
Hr
Hr
Hr
Hr
Hr
Hr
Hr
Hr
Hr
"}
(87,1,1) = {"
Hr
Hr
Hr
Hr
Hr
Hr
Hr
Hr
Hr
Hr
Hr
Hr
Hr
Hr
Hr
Hr
Hr
Hr
Hr
Hr
Hr
Hr
Hr
Hr
Hr
Hr
Hr
Hr
Hr
Hr
Hr
Hr
Hr
Hr
Hr
Hr
Hr
Hr
Hr
Hr
"}
(88,1,1) = {"
Hr
Hr
Hr
Hr
Hr
Hr
Hr
Hr
Hr
Hr
Hr
Hr
Hr
Hr
Hr
Hr
Hr
Hr
Hr
Hr
Hr
Hr
Hr
Hr
Hr
Hr
Hr
Hr
Hr
Hr
Hr
Hr
Hr
Hr
Hr
Hr
Hr
Hr
Hr
Hr
"}
(89,1,1) = {"
Hr
Hr
Hr
Hr
Hr
Hr
Hr
Hr
Hr
Hr
Hr
Hr
Hr
Hr
Hr
Hr
Hr
Hr
Hr
Hr
Hr
Hr
Hr
Hr
Hr
Hr
Hr
Hr
Hr
Hr
Hr
Hr
Hr
Hr
Hr
Hr
Hr
Hr
Hr
Hr
"}
(90,1,1) = {"
Hr
Hr
Hr
Hr
Hr
Hr
Hr
Hr
Hr
Hr
Hr
Hr
Hr
Hr
Hr
Hr
Hr
Hr
Hr
Hr
Hr
Hr
Hr
Hr
Hr
Hr
Hr
Hr
Hr
Hr
Hr
Hr
Hr
Hr
Hr
Hr
Hr
Hr
Hr
Hr
"}
(91,1,1) = {"
Hr
Hr
Hr
Hr
Hr
Hr
Hr
Hr
Hr
Hr
Hr
Hr
Hr
Hr
Hr
Hr
Hr
Hr
Hr
Hr
Hr
Hr
Hr
Hr
Hr
Hr
Hr
Hr
Hr
Hr
Hr
Hr
Hr
Hr
Hr
Hr
Hr
Hr
Hr
Hr
"}
